8 8
**********
*        *
*       B*
*a       *
*       C*
*b       *
*        *
*c      A*
*        *
**********
