5 6
********
*A     *
*C  a  *
* b    *
*B  c  *
*      *
********